ADJ	ADJ
ADV	ADV
COMP	SCONJ
CONJ_CORD	CONJ
CONJ_SUB	SCONJ
DEF	DET
FOC	ADV
FUT	PART
GEN	PART
GEN_DEF	PART
GEN_PRON	PRON
HEMM	DET
INT	INTJ
KIEN	AUX
LIL	PART
LIL_DEF	PART
LIL_PRON	PRON
NEG	PART
NOUN	NOUN
NOUN_PROP	PROPN
NUM_CRD	NUM
NUM_FRC	ADJ
NUM_ORD	ADJ
NUM_WHD	NOUN
PART_ACT	ADJ
PART_PASS	ADJ
PREP	ADP
PREP_DEF	ADP
PREP_PRON	ADP
PROG	AUX
PRON_DEM	PRON
PRON_DEM_DEF	PRON
PRON_INDEF	PRON
PRON_INT	PRON
PRON_PERS	PRON
PRON_PERS_NEG	PRON
PRON_REC	PRON
PRON_REF	PRON
QUAN	DET
VERB	VERB
VERB_PSEU	VERB
X_ABV	PROPN
X_BOR	X
X_DIG	NUM
X_ENG	X
X_FOR	X
X_PUN	PUNCT
